MA : MASTER OF ARTS
MBA : MASTER OF BUSINESS ADMINISTRATION
MBM : MASTER OF BUSINESS MANAGEMENT
MBS : MASTER OF BUSINESS STUDIES
MCA : MASTER OF COMPUTING APPLICATIONS
MCOM : MASTER OF COMMERCE
MCS : MASTER OF COMPUTER SCIENCE 
MD : DOCTOR OF MEDICINE
MDES : MASTER OF DESIGN
MDS : MASTER OF DENTAL SCIENCE
ME : MASTER OF ENGINEERING
MED : MASTER OF EDUCATION
MGL : MASTER OF GENERAL LAW 
ML : MASTER OF LAW
MLIBSC : MASTER OF LIBRARY SCIENCE
MMS : MASTER OF MANAGEMENT SCIENCE
MPHARM : MASTER OF PHARMACY
MS : MASTER OF SURGERY 
MSC   : MASTER OF SCIENCE
MSTAT: MASTER OF STATISTICS
MTECH : MASTER OF TECHNOLOGY
LLM : MASTER OF LAW
PGD : POSTGRADUATE DIPLOMA
MIB : MASTER OF INTERNATIONAL BUSINESS
MHR : MASTER OF HUMAN RESOURCES
MCM : MASTER IN COMPUTER MANAGEMENT
MPHIL : MASTER OF PHILOSOPHY
PHD : DOCTOR OF PHILOSOPHY
DSC : DOCTOR OF SCIENCE
OTHER :
